BACK	B AE K
FORWARD	F AO R W ER D
FULL	F UH L
HALF	HH AE F
LEFT	L EH F T
MOVE	M UW V
RIGHT	R AY T
SPEED	S P IY D
ROBOT 	R OW B AA T
A 		EY
TURN	T ER N
SAY		S EY
HELLO	HH EH L OW
GOODBYE G UH D B AY
TELL	T EH L
JOKE	JH OW K
ON		AH N
OFF		AA F
GO 		G OW 
TO		T UW
KITCHEN K IH CH AH N
BEDROOM B EH D R UW M
YARD	Y ER D
THE 	DH AH
POINT  	P OY N T
B 		B IH
SCREAM  S K R IY M
LAUGH   L AE F
C  		S IY
ONE		W AH N
TWO		T UW
THREE	TH R IY
START 	S T AA R T
STOP	S T AA P
YES		Y EH S
NO		N OW